********************
***#************#***
****************#***
********************
********************
********************
********************
********************
**#********#********
*#*********#********
**#********#********
***#*******#********
**#********#********
*#******************
********************
********************
**####*****###******
********************
********************
********************